4 4 4 4 4 4 4 4 4 4 4 4 4 4 4 4 4 4 0 4 4 4 4 4 4 4 4 4 0 4 4 4 4 4 4 4 4 4 4 4 4 4 4 4 4 4 4 4 4 4 
4 4 4 4 4 4 4 0 4 4 4 4 4 4 4 4 4 0 4 0 0 0 0 0 0 0 0 0 4 0 4 4 4 4 0 4 0 4 4 0 4 4 4 4 4 4 4 4 4 4 
4 4 4 4 4 4 4 4 4 0 0 0 4 4 4 4 4 0 4 0 7 8 8 8 8 8 9 0 4 4 4 4 4 4 0 0 4 4 4 4 4 4 4 4 4 4 4 4 4 4 
4 4 4 4 4 4 0 4 4 0 0 0 4 0 4 4 4 4 4 0 10 2 2 2 2 2 11 0 4 0 4 4 4 4 0 4 4 4 4 0 4 4 4 4 4 4 4 4 4 4 
4 4 4 4 4 4 4 4 4 4 4 4 4 4 4 4 0 0 4 0 10 2 2 2 2 2 11 0 4 0 4 4 4 4 4 4 4 4 4 4 4 4 4 4 4 4 4 4 4 4 
4 4 4 4 4 0 4 0 0 0 0 0 0 0 4 4 4 0 4 0 10 2 2 2 2 2 11 0 4 0 4 4 4 4 4 4 4 4 4 4 4 4 4 4 4 4 4 4 4 4 
4 4 4 4 4 4 4 0 0 0 4 0 4 0 4 4 4 4 4 0 12 13 13 13 13 13 14 0 4 4 4 4 4 4 4 4 4 4 4 4 4 4 4 4 4 4 4 4 4 4 4 
4 4 4 4 4 0 4 0 0 4 0 0 4 0 4 0 4 4 4 0 0 0 0 0 0 0 0 0 4 4 4 4 4 4 5 5 5 5 5 5 5 5 5 5 5 5 4 4 4 4 
4 4 4 0 4 0 4 0 4 0 0 0 4 0 4 4 4 4 4 4 4 0 0 0 0 0 4 4 0 0 4 0 4 4 5 5 5 5 5 5 5 5 5 5 5 5 4 4 4 4 
4 4 4 0 0 0 4 0 0 4 0 4 0 0 0 0 4 4 4 4 4 4 0 0 0 4 4 0 4 4 0 4 0 4 5 5 5 5 5 5 5 5 5 5 5 5 4 4 4 4  
4 4 0 4 4 4 4 0 0 0 4 0 0 0 4 4 4 4 4 4 4 4 4 5 4 4 0 0 4 4 0 4 4 4 5 5 5 5 5 5 5 5 5 5 5 5 4 4 4 4 
4 4 4 4 0 4 4 0 4 0 0 4 4 0 4 4 4 4 0 4 4 4 4 5 4 0 4 0 0 0 0 4 4 0 5 5 5 5 5 5 5 5 5 5 5 5 4 4 4 4 
4 4 4 0 0 4 4 4 0 0 0 4 0 0 4 4 4 4 4 4 4 4 4 5 4 0 4 0 0 4 4 4 4 4 5 5 5 5 5 5 5 5 5 5 5 5 4 4 4 0 
4 4 4 4 4 4 0 4 4 4 5 4 4 4 4 4 4 4 4 4 4 4 4 5 4 0 4 4 4 4 0 0 4 4 4 4 4 4 5 5 0 4 0 5 5 5 4 4 4 4 
4 4 4 0 4 0 4 4 0 4 5 4 4 4 3 3 3 4 4 4 4 4 4 5 4 0 4 4 4 4 4 4 4 0 4 4 0 4 5 5 4 4 4 5 5 5 4 4 4 4
4 4 4 4 4 4 0 0 0 4 5 4 4 4 3 3 3 4 4 4 4 4 4 5 4 4 4 4 4 0 4 0 4 4 0 0 4 4 5 5 4 4 0 5 5 5 4 4 4 4 
4 4 4 4 4 0 4 4 0 4 5 4 4 4 3 3 3 4 4 4 4 4 0 5 0 4 4 4 4 0 0 0 4 4 4 4 4 4 5 5 0 4 4 5 5 5 4 4 4 4 
4 4 4 4 4 0 0 0 0 4 5 4 4 4 3 3 3 0 4 4 0 0 0 5 0 0 0 4 4 0 0 4 4 4 4 4 4 4 5 5 4 0 4 5 5 5 4 4 4 4 
4 4 4 4 4 0 4 0 0 4 5 4 0 4 3 3 3 4 4 4 0 1 1 1 1 1 0 4 4 4 4 4 4 4 4 4 0 4 5 5 4 4 4 5 5 5 4 4 4 4 
4 4 4 4 4 0 4 0 0 4 5 4 4 4 4 5 4 4 4 0 0 1 6 6 6 1 0 0 4 4 4 4 4 4 4 4 5 5 5 5 4 4 4 5 5 5 4 4 4 4 
4 4 4 4 4 0 4 0 0 4 5 4 4 4 0 5 0 4 0 0 0 1 6 6 6 1 0 0 0 4 4 4 4 4 4 0 5 0 4 4 4 4 4 4 4 4 4 4 4 4 
4 4 4 4 4 0 4 0 0 4 5 5 5 5 5 5 5 5 5 5 5 1 6 6 6 1 5 5 5 5 5 5 5 5 5 5 5 0 4 4 4 4 4 4 4 4 4 4 4 4 
4 4 4 4 4 0 4 0 0 4 4 4 0 4 4 4 4 4 0 0 0 1 6 6 6 1 0 0 0 4 4 4 4 4 4 4 5 4 4 4 4 4 4 4 4 4 4 4 4 4 
4 4 4 4 4 0 4 0 0 4 4 4 0 4 4 4 4 4 4 0 0 1 1 6 1 1 0 0 4 4 4 4 4 4 4 4 5 4 4 4 4 4 4 4 4 4 4 4 4 4 
4 4 4 4 4 0 4 0 0 4 4 4 0 4 4 4 4 4 4 4 0 0 5 5 5 0 0 4 4 4 4 4 4 4 4 4 5 4 4 4 4 4 4 4 4 4 4 4 4 0 
4 4 4 4 4 0 4 4 0 4 4 4 0 0 0 4 4 4 4 4 4 4 4 5 4 4 4 4 4 4 4 4 4 4 4 4 5 4 4 4 4 4 4 4 4 4 4 4 4 4 
4 4 4 4 4 4 4 4 0 4 4 4 4 4 0 4 4 4 4 4 4 4 4 5 4 4 4 4 4 4 4 4 4 4 4 4 5 4 4 4 4 4 4 4 4 4 4 4 4 4 
4 4 4 4 4 4 4 4 0 4 4 4 4 4 0 4 4 4 4 4 4 4 4 5 4 0 4 0 4 4 4 4 4 4 4 0 5 4 4 4 4 4 4 4 4 4 4 4 4 4 
4 4 4 4 4 4 4 4 0 4 4 4 4 4 0 4 4 4 4 4 4 4 4 5 4 4 4 4 4 4 0 4 4 4 4 4 5 4 4 4 4 4 4 4 4 4 4 4 4 4 
4 4 4 4 4 4 4 4 0 0 0 0 0 0 0 4 4 4 4 4 4 4 4 5 4 0 4 4 4 4 0 4 4 4 4 4 5 4 4 4 4 4 4 4 4 4 4 4 4 4 
4 4 4 4 4 4 4 4 0 0 0 0 0 0 0 4 4 4 4 4 4 4 4 5 4 4 4 4 4 4 4 4 4 4 4 4 0 4 4 4 4 4 4 4 4 4 4 4 4 4 
4 4 4 4 4 4 4 4 0 0 0 0 0 0 0 4 4 4 4 4 4 4 4 5 4 0 4 4 4 4 4 4 4 4 4 0 0 0 4 4 4 4 4 4 4 4 4 4 4 4 
4 4 4 4 4 4 4 4 0 0 0 0 0 0 0 4 4 4 4 4 4 4 4 5 4 4 4 4 4 4 4 4 4 4 4 0 0 0 4 4 4 4 4 4 4 4 4 4 4 4 
4 4 4 4 4 4 4 4 0 0 0 0 0 0 0 4 4 4 4 4 4 4 4 5 4 4 4 4 4 4 4 4 4 4 4 0 0 0 4 4 4 4 4 4 4 4 4 4 4 4 
4 4 4 4 4 4 4 4 0 0 0 0 0 0 0 4 4 4 4 4 4 4 4 5 4 4 4 4 0 4 4 4 4 4 4 0 0 0 4 4 4 4 4 4 4 4 4 4 4 4 
4 4 4 4 4 4 4 4 4 4 4 4 4 4 4 4 4 4 4 4 4 4 4 5 4 4 4 4 4 4 4 4 4 4 4 0 0 0 4 4 4 4 4 4 4 4 4 4 4 4 
4 4 4 4 4 4 4 4 4 4 4 4 4 4 4 4 4 4 4 0 0 0 0 0 0 0 0 4 4 4 4 4 4 4 0 0 0 0 0 4 4 4 4 4 4 4 4 4 4 4 
4 4 4 4 4 4 4 4 4 4 4 4 4 4 4 4 4 4 0 0 0 0 0 0 0 0 0 0 4 4 0 4 4 0 0 0 0 0 0 4 4 4 4 4 4 4 4 4 4 4 
4 4 4 4 4 4 4 4 4 4 4 4 4 4 4 4 4 4 0 0 0 0 0 0 0 0 0 0 4 4 4 4 0 0 0 0 0 0 0 4 4 4 4 4 4 4 4 4 4 4 
4 4 4 4 4 4 4 4 4 4 4 4 4 0 4 4 4 4 0 0 0 0 0 0 0 0 0 0 0 4 4 4 0 0 0 0 0 4 0 4 4 4 4 4 4 4 4 4 4 4 
4 4 4 4 4 4 4 4 4 4 4 4 4 4 4 4 4 4 0 0 0 0 0 0 0 0 0 0 0 0 0 0 0 0 4 0 0 0 0 4 4 4 4 4 4 4 4 4 4 4 
4 4 4 4 4 4 4 4 4 4 4 4 4 0 4 4 4 4 4 0 0 0 0 0 0 0 0 4 4 4 4 0 0 0 0 0 0 0 0 4 4 4 4 4 4 4 4 4 4 4 
4 4 4 4 4 4 4 4 4 4 4 4 4 4 4 4 4 4 4 4 0 0 0 0 0 0 4 4 4 4 4 0 0 4 0 0 4 0 0 4 4 4 4 4 4 4 4 4 4 4 
4 4 4 4 4 4 4 4 4 4 4 4 4 4 4 4 4 4 4 4 4 4 4 4 4 4 4 4 4 4 4 4 0 0 0 0 0 0 4 4 4 4 4 4 4 4 4 4 4 4 
4 4 4 4 4 4 4 4 4 4 4 4 4 4 4 4 4 4 4 4 4 4 4 4 4 4 4 4 4 4 4 4 4 4 4 4 4 4 4 4 4 4 4 4 4 4 4 4 4 4 
4 4 4 4 4 4 4 4 4 4 4 4 4 4 4 4 4 4 4 4 4 4 4 4 4 4 4 4 4 4 4 4 4 4 4 4 4 4 4 4 4 4 4 4 4 4 4 4 4 4 
4 4 4 4 4 4 4 4 4 4 4 4 4 4 4 4 4 4 4 4 4 4 4 4 4 4 4 4 4 4 4 4 4 4 4 4 4 4 4 4 4 4 4 4 4 4 4 4 4 4 
4 4 4 4 4 4 4 4 4 4 4 4 4 4 4 4 4 4 4 4 4 4 4 4 4 4 4 4 4 4 4 4 4 4 4 4 4 4 4 4 4 4 4 4 4 4 4 4 4 4 
4 4 4 4 4 4 4 4 4 4 4 4 4 4 4 4 4 4 4 4 4 4 4 4 4 4 4 4 4 4 4 4 4 4 4 4 4 4 4 4 4 4 4 4 4 4 4 4 4 4 
4 4 4 4 4 4 4 4 4 4 4 4 4 4 4 4 4 4 4 4 4 4 4 4 4 4 4 4 4 4 4 4 4 4 4 4 4 4 4 4 4 4 4 4 4 4 4 4 4 4 